aar: Afar
abk: Abkhazian
ace: Achinese
ach: Acoli
ada: Adangme
ady: Adyghe; Adygei
afa: Afro-Asiatic
afh: Afrihili
afr: Afrikaans
ain: Ainu
aka: Akan
akk: Akkadian
alb: Albanian
ale: Aleut
alg: Algonquian
alt: Southern Altai
ang: English, Old
amh: Amharic
anp: Angika
apa: Apache
ara: Arabic
arc: Official Aramaic
arg: Aragonese
arm: Armenian
arn: Mapudungun
arp: Arapaho
art: Artificial
arw: Arawak
asm: Assamese
ast: Asturian
ath: Athapascan
aus: Australian
ava: Avaric
ave: Avestan
awa: Awadhi
aym: Aymara
aze: Azerbaijani
bad: Banda
bai: Bamileke
bak: Bashkir
bal: Baluchi
bam: Bambara
ban: Balinese
baq: Basque
bas: Basa
bat: Baltic
bej: Beja; Bedawiyet
bel: Belarusian
bem: Bemba
ben: Bengali
ber: Berber
bho: Bhojpuri
bih: Bihari
bik: Bikol
bin: Bini; Edo
bis: Bislama
bla: Siksika
bnt: Bantu
bos: Bosnian
bra: Braj
bre: Breton
btk: Batak
bua: Buriat
bug: Buginese
bul: Bulgarian
bur: Burmese
byn: Blin; Bilin
cad: Caddo
cai: Central American Indian
car: Galibi Carib
cat: Catalan
cau: Caucasian
ceb: Cebuano
cel: Celtic
cha: Chamorro
chb: Chibcha
che: Chechen
chg: Chagatai
chi: Chinese
chk: Chuukese
chm: Mari
chn: Chinook jargon
cho: Choctaw
chp: Chipewyan
chr: Cherokee
chu: Old Slavonic/Bulgarian
chv: Chuvash
chy: Cheyenne
cmc: Chamic
cnr: Montenegrin
cop: Coptic
cor: Cornish
cos: Corsican
cpe: Creoles/pidgins, English
cpf: Creoles/pidgins, French
cpp: Creoles/pidgins, Portuguese
cre: Cree
crh: Crimean Tatar/Turkish
crp: Creoles and pidgins
csb: Kashubian
cus: Cushitic
cze: Czech
dak: Dakota
dan: Danish
dar: Dargwa
day: Land Dayak
del: Delaware
den: Slave (Athapascan)
dgr: Dogrib
din: Dinka
div: Divehi/Dhivehi
doi: Dogri
dra: Dravidian
dsb: Lower Sorbian
dua: Duala
dum: Dutch, Middle
dut: Dutch; Flemish
dyu: Dyula
dzo: Dzongkha
efi: Efik
egy: Egyptian (Ancient)
eka: Ekajuk
elx: Elamite
eng: English
enm: English, Middle
epo: Esperanto
est: Estonian
ewe: Ewe
ewo: Ewondo
fan: Fang
fao: Faroese
fat: Fanti
fij: Fijian
fil: Filipino/Pilipino
fin: Finnish
fiu: Finno-Ugrian
fon: Fon
fre: French
frm: French, Middle
fro: French, Old
frr: Northern Frisian
frs: Eastern Frisian
fry: Western Frisian
ful: Fulah
fur: Friulian
gaa: Ga
gay: Gayo
gba: Gbaya
gem: Germanic
geo: Georgian
ger: German
gez: Geez
gil: Gilbertese
gla: Gaelic
gle: Irish
glg: Galician
glv: Manx
gmh: German, Middle High
goh: German, Old High
gon: Gondi
gor: Gorontalo
got: Gothic
grb: Grebo
grc: Greek, Ancient
gre: Greek, Modern
grn: Guarani
gsw: Swiss German
guj: Gujarati
gwi: Gwich'in
hai: Haida
hat: Haitian
hau: Hausa
haw: Hawaiian
heb: Hebrew
her: Herero
hil: Hiligaynon
him: Himachali
hin: Hindi
hit: Hittite
hmn: Hmong; Mong
hmo: Hiri Motu
hrv: Croatian
hsb: Upper Sorbian
hun: Hungarian
hup: Hupa
iba: Iban
ibo: Igbo
ice: Icelandic
ido: Ido
iii: Sichuan Yi; Nuosu
ijo: Ijo
iku: Inuktitut
ile: Interlingue; Occidental
ilo: Iloko
ina: Interlingua
inc: Indic
ind: Indonesian
ine: Indo-European
inh: Ingush
ipk: Inupiaq
ira: Iranian
iro: Iroquoian
ita: Italian
jav: Javanese
jbo: Lojban
jpn: Japanese
jpr: Judeo-Persian
jrb: Judeo-Arabic
kaa: Kara-Kalpak
kab: Kabyle
kac: Kachin; Jingpho
kal: Kalaallisut; Greenlandic
kam: Kamba
kan: Kannada
kar: Karen
kas: Kashmiri
kau: Kanuri
kaw: Kawi
kaz: Kazakh
kbd: Kabardian
kha: Khasi
khi: Khoisan
khm: Central Khmer
kho: Khotanese; Sakan
kik: Kikuyu; Gikuyu
kin: Kinyarwanda
kir: Kirghiz; Kyrgyz
kmb: Kimbundu
kok: Konkani
kom: Komi
kon: Kongo
kor: Korean
kos: Kosraean
kpe: Kpelle
krc: Karachay-Balkar
krl: Karelian
kro: Kru
kru: Kurukh
kua: Kuanyama; Kwanyama
kum: Kumyk
kur: Kurdish
kut: Kutenai
lad: Ladino
lah: Lahnda
lam: Lamba
lao: Lao
lat: Latin
lav: Latvian
lez: Lezghian
lim: Limburgan
lin: Lingala
lit: Lithuanian
lol: Mongo
loz: Lozi
ltz: Luxembourgish
lua: Luba-Lulua
lub: Luba-Katanga
lug: Ganda
lui: Luiseno
lun: Lunda
luo: Luo (Kenya/Tanzania)
lus: Lushai
mac: Macedonian
mad: Madurese
mag: Magahi
mah: Marshallese
mai: Maithili
mak: Makasar
mal: Malayalam
man: Mandingo
mao: Maori
map: Austronesian
mar: Marathi
mas: Masai
may: Malay
mdf: Moksha
mdr: Mandar
men: Mende
mga: Irish, Middle
mic: Mi'kmaq; Micmac
min: Minangkabau
mis: Uncoded
mkh: Mon-Khmer
mlg: Malagasy
mlt: Maltese
mnc: Manchu
mni: Manipuri
mno: Manobo
moh: Mohawk
mon: Mongolian
mos: Mossi
mri: Maori
msa: Malay
mul: Multiple
mun: Munda
mus: Creek
mwl: Mirandese
mwr: Marwari
myn: Mayan
myv: Erzya
nah: Nahuatl
nai: North American Indian
nap: Neapolitan
nau: Nauru
nav: Navajo; Navaho
nbl: South Ndebele
nde: North Ndebele
ndo: Ndonga
nds: Low German
nep: Nepali
new: Nepal Bhasa; Newari
nia: Nias
nic: Niger-Kordofanian
niu: Niuean
nld: Dutch; Flemish
nno: Norwegian
nob: Bokmål
nog: Nogai
non: Norse, Old
nor: Norwegian
nqo: N'Ko
nso: Pedi; Sepedi
nub: Nubian
nwc: Classical Newari
nya: Chichewa; Nyanja
nym: Nyamwezi
nyn: Nyankole
nyo: Nyoro
nzi: Nzima
oci: Occitan
oji: Ojibwa
ori: Oriya
orm: Oromo
osa: Osage
oss: Ossetian; Ossetic
ota: Turkish, Ottoman
oto: Otomian
paa: Papuan
pag: Pangasinan
pal: Pahlavi
pam: Pampanga
pan: Panjabi/Punjabi
pap: Papiamento
pau: Palauan
peo: Persian, Old
per: Persian
phi: Philippine
phn: Phoenician
pli: Pali
pol: Polish
pon: Pohnpeian
por: Portuguese
pra: Prakrit
pro: Provençal, Old
pus: Pushto; Pashto
que: Quechua
raj: Rajasthani
rap: Rapanui
rar: Rarotongan; Maori
roa: Romance
roh: Romansh
rom: Romany
rum: Romanian; Moldavian
run: Rundi
rup: Aromanian; Arumanian
rus: Russian
sad: Sandawe
sag: Sango
sah: Yakut
sai: South American Indian
sal: Salishan
sam: Samaritan Aramaic
san: Sanskrit
sas: Sasak
sat: Santali
scc: Serbian
scn: Sicilian
sco: Scots
scr: Croatian
sel: Selkup
sem: Semitic
sga: Irish, Old
sgn: Sign
shn: Shan
sid: Sidamo
sin: Sinhala
sio: Siouan
sit: Sino-Tibetan
sla: Slavic
slo: Slovak
slv: Slovenian
sma: Southern Sami
sme: Northern Sami
smi: Sami
smj: Lule Sami
smn: Inari Sami
smo: Samoan
sms: Skolt Sami
sna: Shona
snd: Sindhi
snk: Soninke
sog: Sogdian
som: Somali
son: Songhai
sot: Sotho, Southern
spa: Spanish; Castilian
srd: Sardinian
srn: Sranan Tongo
srp: Serbian
srr: Serer
ssa: Nilo-Saharan
ssw: Swati
suk: Sukuma
sun: Sundanese
sus: Susu
sux: Sumerian
swa: Swahili
swe: Swedish
syc: Classical Syriac
syr: Syriac
tah: Tahitian
tai: Tai
tam: Tamil
tat: Tatar
tel: Telugu
tem: Timne
ter: Tereno
tet: Tetum
tgk: Tajik
tgl: Tagalog
tha: Thai
tib: Tibetan
tig: Tigre
tir: Tigrinya
tiv: Tiv
tkl: Tokelau
tlh: Klingon; tlhIngan-Hol
tli: Tlingit
tmh: Tamashek
tog: Tonga (Nyasa)
ton: Tonga (Tonga Islands)
tpi: Tok Pisin
tsi: Tsimshian
tsn: Tswana
tso: Tsonga
tuk: Turkmen
tum: Tumbuka
tup: Tupi
tur: Turkish
tut: Altaic
tvl: Tuvalu
twi: Twi
tyv: Tuvinian
udm: Udmurt
uga: Ugaritic
uig: Uighur; Uyghur
ukr: Ukrainian
umb: Umbundu
und: Undetermined
urd: Urdu
uzb: Uzbek
vai: Vai
ven: Venda
vie: Vietnamese
vol: Volapük
vot: Votic
wak: Wakashan
wal: Wolaitta; Wolaytta
war: Waray
was: Washo
wel: Welsh
wen: Sorbian
wln: Walloon
wol: Wolof
xal: Kalmyk; Oirat
xho: Xhosa
yao: Yao
yap: Yapese
yid: Yiddish
yor: Yoruba
ypk: Yupik
zap: Zapotec
zbl: Blissymbols
zen: Zenaga
zgh: Moroccan Tamazight
zha: Zhuang; Chuang
znd: Zande
zul: Zulu
zun: Zuni
zxx: No linguistic content
zza: Zaza; Zazaki
off: No Language
